TTTTTPTTTT
TTTTTTTTTT
TTTTTTTTTT
KTTTTTTTTT
TTTTTTTTTP
TTVTTTTTTT
TTTTTTTTTT
TTTTTTTTTT
TTTTTVTTTT
TTTTTTTTTT
31