TTTTTTTTTT
TTTTTTTTTT
TTVTTTTTTT
TTTTTTTVTT
PTTTTTTTTP
TTTTTTTTTT
TTTTTTTTTT
TTTTCTTTTT
TTTTTTTTTT
TTTTPTTTTT
243